........................
........................
........................
........................
........................
........................
.......#................
...#...#................
########################
........................
........................