...........................
...........................
...........................
...........................
...........................
............../............
........./#\...............
./@...3..###\....2.........
###########################
...........................
...........................