........................
........................
........................
........................
........................
........................
....../#\...............
...3..###\....2.........
########################
........................
........................