#..........................#
#..........................#
#..........................#
#..........................#
#...\......................#
#............../...........#
#........./#\..............#
#./@...3..###\....2........#
############################
#..........................#
#..........................#